000000000000000000000
000;D6D<0000000000000
000733380000000000000
000733380000000000000
000733380000000000000
00073339DDDDDDDDDDD<0
000744444444444444480
000744444444444444480
000HEEEEEEEEEEEEG==80
0000;DDDDDDDDDDD:==80
000074444444444444480
0000744FEEEEEEEEEEEI0
000074480000000000000
000074480000000000000
0000HCEI0000000000000
00000-000000000000000
0;DDD6DDD<00000000000
074444444800000000000
074444444800000000000
074444444800000000000
0HEEEEEEEI00000000000