00000000000000000000000000000
0000000000000000;D6D<;DDD<000
00000000000000007222872228000
00000000000000007222872228000
00000000000000007222872228000
00000000000000007222BA2228000
0000000000000000722287222TNK0
0000000000000000HEEEIHEEEI0R0
0000000000000000000000;D<00R0
0;DDDDD<0000000000000071TNNL0
07=====9DDDDDDDDDDDDDD:180000
07=====1111111111111111180000
07=====FEEEG1FEEEEEEG1FEI0000
07===FEI000718000000718000000
07===800000718000000718000000
0HG1FI22220718055550718055550
00718022>>07=8055550718055550
007180222207=8055550718055550
007180;6<00718000000718000000
;D:19D:19DD:19DDDDDD:19DDDDD<
71111111111111111111111111118
74444444444444444444444444448
71111111111111111111111111118
HEEEEEEEEEEEEEEEG1FEEEEEEEG18
0000000000000000HCI0000000HCI
0000005555000002>220000022220
0000005555000002>220000022220
0000005555000002>2200000>>>>0
00000000000000000000000000000