00000000000000000000000000000000000000000
000000;DDDDD<000000000000000000DDDD6DDDD0
00000072222280000000000000000000000100000
00000072222280000000000000000000000100000
000000HEECEEI0000000000000000000000100000
00;DDDDDD6DDDDDDDDDDDDDDDD<00000000100000
00755555515555555555555555800;DDDDD6DDD<0
00751444444444444444444415800722222222280
00753555555555555555555535800722222222280
007535FEEEEEEEEEEEEEEEG5359D<722222222280
007535TNNNNNNNNNNNNNNNS535558722222222280
0075358000000000000000751444BA22222222280
00753580000000000000007555558722222222280
0075358000000000000000HEEEEEI722222222280
00753580000000000000000000000HEEEEEEECEI0
0075358;DDDDDD<;DDDDD<0000000000000;D6D<0
00753587222222BA1111180000000000000753580
007531BA2222228HEEEG180000000000000753580
00753587222222800007180000000000000753580
0075358HEEEEEEI00007180000000000000753580
00753580000000000007180000000000000753580
0075358000000000000HCI0000000000000753580
0075359DDD<0000000;D6DD<00000000000753580
00753555558000000072222800000000000753580
00751441158000000072222800000000000753580
007555131580000000722228000;DDDD<00753580
00HEG513158000000072222800072222800753580
0000HEECEEI000000072222800072222800753580
00;DDDD6DDDDD<000072222TNNNS2222800753580
00722222222228;DD<72222800072222800753580
0072222222222BA11BA2222800072222800753580
00722222222228HEEI722228000HEEEEI00753580
007222222222280000HEEEEI00000000000753580
00HEECEEEEECEI000000000000000000000753580
00;DD6DD<;D6DDDDDDDDDDDDDDDDDDDDDDD:53580
00751315875555555555555555555555555553580
00751315875444444444444444444444444441580
00751315875555555555555555555555555555580
007513158HEEEEEEEEEEEEEEEEEEEEEEEEEEEEEI0
00755555800000000000000000000000000000000
00HEEEEEI00000000000000000000000000000000