;DDDDDDDDDDDDDDDDDDDDDDD<
7222222222222222222222228
7222222222222222222222228
7222222222222222222222228
7222222222222222222222228
7222222222222222222222228
7222222222222222222222228
7222222222222222222222228
7222222222222222222222228
7222222222222222222222228
7222222222222222222222228
7222222222222222222222228
7222222222222222222222228
7222222222222222222222228
7222222222222222222222228
7222222222222222222222228
7222222222222222222222228
7222222222222222222222228
7222222222222222222222228
7222222222222222222222228
7222222222222222222222228
7222222222222222222222228
7222222222222222222222228
7222222222222222222222228
HEEEEEEEEEEEEEEEEEEEEEEEI