000000000000000000000000000
00000000000JNNNNNNNNNNNK000
0000000000;?DDDDDDD<000R000
0000;6<000711111111TNNNP000
00007380007111111118000R000
0000738000HCEEEG11FI;DD?DD<
0000739DDDD6<00711807111118
00007333333380;:119<7111118
0000HEEEG333807111187111118
00000000HEEEI0HG11FI7111118
0;DDDDD<000000;:119<7111118
0711111800000071111BA111118
07111118;DDDD<HG11FI7111118
071FECEI711118;:119<7111118
0718;6D<711118711118HEEEEEI
0HEI7119:11118HG11FI0000000
0000711111111807119DDDDD<00
00007111111119D:11111111800
0000711FG111111111FEEG11800
000071187111111111800711800
00007118HEEEEEEEEEI00711800
00007119DDDDDDDDDDDDD:119<0
000071111111111111111111180
000071111111111111111111180
0000HEEEEG11111111111111180
0;DD<0000HEEEEG11FEECEEG180
071180000000007118;D6D<7180
07118;D<;D<;D<7118711187180
;:119:19:19:19:118711187180
711111111111111118HEEEI7180
711111111111111119DDDDD:180
71111111111111111>>11111180
71111111111111111FG11111180
HEEEEG1FG1FG1FEEEI711111180
00000HEIHEIHEI0000711111180
000000000000000000711111180
000000000000000000HEEEEEEI0
000000000000000000000000000