00000000000000000000000
0JNNNNK0;D6D<0000000000
0R0;DD?<711180000000000
0R07>>>9:11180000000000
0R07>>>1111180000000000
0R07>>>FEEEEI0000000000
0R07>>>9<00000000000000
0R07>>>>800000000000000
0R07>>>FI0000JNNNNNNNK0
0R07>>>800000R0000000R0
0R07>>>8;D<0;?<0;DD<0R0
0R07>>>9:19D:19D:1180R0
0R07>>>11111111111180R0
0R07>>>F@EEEEEEEG1180R0
0R0HEEEIR000000071180R0
0QNNNNNNL000000071180R0
0R0000000000000071180R0
;?DDDDD<00000;DD:119D?<
71111228000007222222228
7111122800000722FEEEEEI
71111228;DDDD:228000000
71111228733333228;DD<00
71111228722222228722800
71111228722222228HG2800
7111122BA1FEEEG19D:>9<0
HEEEEEEI718000711111180
000000;D:18000711111180
00000071118000HEEEEEEI0
0;DDD<71118000000000000
07111BA1118000000000000
0HG1FIHEEEI000000000000
00718000000000000000000
00HCI000000000000000000
00000000000000000000000