000000000000000000000000000000
0;DDDDDDDDDDDDDDD<000000000000
071111111111111118000000000000
071111111111111118000000000000
071111111111111118000000000000
071111111111111118000000000000
07111111111111111TNNNNNNNNNNNK
0HEECEEEEEEEEEEEEI00000000000R
00;D6DDDDDDDDDDDD<;DDDDDDDDD<R
00711111111111111871111111118R
0071111111111111187111111111TP
00711111111111111871111111118R
007111111111111118HEEEEECEEEIR
00711111111111111BA111181;DD<R
00711111111111111871111817118R
00711111111111111871111817118R
00711111111111111871111817118R
00711111111111111871111B17118R
007111111111111118HEEEEI17118R
007111111111111118;DDDD<17118R
00711111111111111871111B1A118R
0071111111111111187111181HEEIR
00HCEEEEG1111111187111181;DD<R
00;6DDD<71111111187111181A118R
007111187111111118HEEEEI0HEEIR
007111187111111119DDDD<000000R
0071111871111111111111TNNNNNNL
007111187111111111111180000000
00HEEEEIHEEEEECEEEEEEEI0000000
000000000000000000000000000000